%%%%%%%%%%%%%%%%%%%%%%%%%%%%
% .%%%%%%%   %%%%%%%%   G%%%
%%% %%%%%% %%%%%%%%%% %%%%%%
%   %    % %      G % %   G%
% %%% %% % % %%%%%%% % %%% %
% %    % % % %    %  %   % %
% % %% % % % % %% % % % % % %
% % %% % % % % %% % % % % % %
% %    %   % %    % %   % % %
% %%%%%%%%% % %%%%% %%%%% % %
%   G    % % %   %     % % %
%%% %%%%%% % % % % %%% % % %
%   %    % % % % %   % %   %
% %%% %% % % % % %%% % %%%%%
% %    % %   % %   % %    G%
% %%%%%% %%%%% % %%% % %%%%%%
% G    %      %   G  %     %
%%% %%%%%%%%%%%%%%%%%%%%% %%%
%P          o      o       %
%%%%%%%%%%%%%%%%%%%%%%%%%%%%
