%%%%%%%%%%%%%%%%%%%%%
%       %      %   P%
%       %%%%%       %
%   %           %   %
%   %   %%%%%   %   %
%   %           %   %
%       %%%%%       %
%.                  %
%%%%%%%%%%%%%%%%%%%%%
